blue: 0,A
red: 1,B,C
++++++++++++
+B     C  A+
+++++ ++++++
+bac     10+
++++++++++++
