red: 0,A,B,C,D,Z
green: 1,E,F,G,H
blue: 2,I,J,K
yellow: 3,M,N,O
cyan: 4,Q,R,S,T
magenta: 5,U,V,W,X,Y
pink: 6,7,8
orange: L,P
++++++++++++++++++++++++++++++++++++++++++++++++++
+ABCDZ                                      abcdz+
+           +      +         +++++++++++++++++++++
+EFGH   +                  + +               efgh+
+                            ++++++++++++++ ++++++
+IJK        +                                 ijk+
+                 +    +     +++++++++++++++++++++
+MNO   +                   +                  mno+
+                            ++++++++++++++ ++++++
+QRST        +      +        +               qrst+
+                   +        +++++++++++++++++++++
+UVWXY      +              +                uvwxy+
+              +             +++++++++++++++++++++
+        +                                       +
+     +            +         +++++++++++++++++++++
+                          +                +    +
+       +                    +++++++++++++++++++++
+       +    ++                       +          +
+    +    +   +     +        +++++++++++++++++++++
+       +         +        +    +                +
+                            +++++++++++++++++++++
+                        +                      ++
+   +                         +      +       +   +
+            +          +                        +
+           +   +                                +
+  +  +     +   +                               ++
+     +     +   +                                +
+           +   +                    +           +
+   +   +   +   +                                +
+           +   +                            +   +
+      +    +   +      +                         +
+           +   +                                +
+    ++     +   +                   +            +
+           +   +                                +
+ +   +     +   +        +                       +
+           +   +                                +
+       +   +   +                +         +     +
+   +           +                                +
+           +   +         +                      +
+  +   +    +   +                                +
+           +   +                                +
+  +     +  +   +                      +         +
+    +      +   +                                +
+           +   +       +       +                +
+           +   +                                +
+           +   +                                +
+           + L +                             P  +
++++++6++++++ +            +    +        +       +
+0 1 2 3 4 5+                                    +
++++++++++++++++++++++++++++++++++++++++++++++++++
