blue: 0,A,E
red: 1,B
yellow: 2,C
green: 3,D
cyan: 4
+++++++++++++
+A        3 +
+   +++++++ +
+B  +     + +
+1  + +++ + +
+   +4+a+ + +
+   +C  +b+ +
+0  +++++ +D+
+   E     +2+
+++++++++ +++
+++++++++++++
