red: 0,4,8,A,B,C
blue: 1,5,9,D,E,F,G
cyan: 2,6,H,I,J,K,L
magenta: 3,7,M,N,O
++++++++++++++++++++++++++++++++++++++++++++++++
+                    D  +  0                  a+
+                       +                      +
+                       +                      +
+     +                 +                      +
+      +                +      +++++++++++++++++
+       +               +                      +
+        +              +                      +
+ d                   9 +                   A  +
++++++++++++++++++++++++++++++++++++++++++++++++
+ 8                  B  +  1                  e+
+                       +                      +
+                       +                      +
+     +                 +                      +
+      +                +    +++++++++++++++++++
+       +               +                      +
+        +              +                      +
+ b                     +                   E  +
++++++++++++++++++++++++++++++++++++++++++++++++
+ 7                  M  +  2                  h+
+                       +                      +
+                       +                      +
+     +                 +                      +
+      +                +      +++++++++++++++++
+       +               +                      +
+        +              +                      +
+ m                   M +                   H  +
++++++++++++++++++++++++++++++++++++++++++++++++
+ 6                  J  +  N                  n+
+                       +                      +
+                       +                      +
+     +                 +                      +
+      +                +      +++++++++++++++++
+       +               +                      +
+        +              +                      +
+ j                  J  +                   3  +
++++++++++++++++++++++++++++++++++++++++++++++++
+ 5                  G  +  4                  c+
+                       +                      +
+                       +                      +
+      +                +      +++++++++++++++++
+       +               +                      +
+        +G             +                   M  +
+ g                     +                  MC  +
++++++++++++++++++++++++++++++++++++++++++++++++
