red: 0,A
green: 1,B,F
pink: 2,C,N
++++++++++++++++++++++++++++
+   b         0         a  +
+ f   1 +   B F            +
+c+++++++++++++++++  C    c+
+     2                    +
+   +                   A  +
+   +      BANANA          +
+       c           C      +
+ C a                     n+
++++++++++++++++++++++++++++
