blue: 0,A,B,C,F
red: 1,G,E,H,I
green: 2,D
++++++++++++++++++++++++++++++++++++
+          f   F           ++    D +
+      I A BC              +d      +
+    H                     +++++++c+
+ G                              +b+
+1                              0+a+
+                                  +
+                                  +
+    E                             +
++++++++++++i+++++++++++++++++++++++
+e+                                +
+g+                                +
+h+                                +
+                                  +
+                                  +
+                          2       +
+                                  +
++++++++++++++++++++++++++++++++++++
