blue: 0,A,C,E
red: 1,D
green: 2,B
+++++++++++++
+0   D  +b a+
+ 2   A +++d+
+ 1  E  +++e+
+C     B c  +
+++++++++++++
