red: 0,A
green: 1,B
yellow: 2,C
+++++++++++++++++++++++
+a c ++++    B   B   b+
+   0BBBB         1   +
+    ++++       CCC  b+
+2   BBBB       CAC  C+
+++++++++++++++++++++++
