red: 0,A
blue:1,B
green:2,C
+++++++++++
+   1+Aa  +
+    +    +
+c        +
+    +    +
+    +    +
+    +    +
+   C+2   +
+    +    +
+    +    +
+         +
+    +    +
+    +    +
+    +    +
+  bB+0   +
+++++++++++
