red: 0,A,B,C
green: 1,X,Y,Z
+++++++++++++++
+0XY          +
+++         BA+
+      1      +
+             +
+b+++++++++++y+
+a+++++++++++x+
+++++++++++++++
