red: 1,5,8,B,T,X
green: 3,7,C,O,Z
blue: 0,2,6,9,A,S,Y
pink: 4,M
+++++++++++++++++++++++++++
+0 AAa   aaSS+a+ Y +Z     +
+A  A    +aSS+ +   +++ ++X+
+AAAa    +S+a+ +567b++z++A+
+AAa     +a+++ ++ ++++ ++c+
+a       +  ++ ++C++++ B+++
+        + +++   x  y     +
+++++++++++++++++++++++++++
+MMMOOOSSSTTT+8B         9+
+MMMOOOSSSTTT+            +
+  1 2 3 4   +S++++++++++A+
+            +TSTSTSTSba+S+
+mostmostmost+S++++++++++ +
+ostostostmmm+      T     +
+++++++++++++++++++++++++++
