red: 0,C,A
green: 1,B
++++++++++++
+       0+a+
+ +C++++++A+
+ c        +
+B++++++++ +
+b+1       +
++++++++++++
