red:0,2,3,A,G,C,D
blue:4,5,B
yellow:1,H
++++++++++++++++++
+++A            B+
+G+++++++ ++++++++
+   +d  + +4C    +
+ + +   + ++++   +
+ + +   + +  +   +
+ + +D  + + ++   +
+g  +   + + 5+   +
+h++++ ++ +++++ ++
+ H             c+
+ +++++++  +++++++
+0321b          a+
++++++++++++++++++
