red: 0,A
green: 1,B
blue: 2,C
yellow: 3,D
++++++++++++++++++++++++++++++++++++++++
+a+                   +    +++         +
+b+                   +    +C+         +
+c+                   +    + +++++++++++
+ +                        +           +
+ +++++               +    + ++ + + +  +
+                     +++ ++ +  + + +  +
++++++++++++++        +   +  +  + + +  +
+                     + + + ++  + + +  +
+                     + + + ++  + + +  +
+                     + + + ++  + + +  +
+                     +D+ + ++  + + +  +
+                     +3+ + ++  + + +  +
+                     +++ + ++  + + +  +
+                       + + +   + + +  +
+                       + + +   + + +  +
+  2                    +   +   + + +  +
+                       +++++   ++++++ +
+           ++++++++++++++B+           +
+           +             d+           +
+           + ++++++++++++++           +
+           + +            +           +
+         +++ +++++++++++++++++++++++ ++
+1        +                          A0+
++++++++++++++++++++++++++++++++++++++++
