++++++++++++++++++++
+0ZA  Z     Z     a+
+ Z Z    ZZZZ ZZZZZ+
+ Z   Z   Z Z      +
+ Z ZZZ Z Z ZZZZZZ +
+ Z   Z   Z      Z +
+ ZZZ ZZ ZZZZZZZ Z +
+ Z           ZZ   +
+ Z    ZZZZZZZ     +
+ Z  Z        ZZ   +
+ Z ZZZ Z Z Z Z ZZ +
+ ZZZ ZZ ZZ ZZ Z Z +
+ Z            ZZZ +
+ Z    ZZZZZ Z     +
+ Z        Z  ZZZZ +
+ Z ZZZ Z Z Z ZZZZ +
+ Z   Z   Z      Z +
+ ZZZ ZZ ZZZ ZZZZZ +
+ Z            Z   +
+ Z    ZZZZZZZ     +
+ Z     Z  Z   Z   +
+ Z Z Z Z Z Z  Z   +
+ Z Z Z Z Z Z ZZ   +
+              Z   +
+ ZBZZZ Z Z ZZZZZZ +
+ Z   Z   Z      Z +
+ ZZZ ZZ ZZZZZZZ Z +
+ Z            Z   +
+bZ    ZZZZZZZ     +
++++++++++++++++++++
