+++++++++++++++++++++++++++++++++
++aAA+++++++++++AAAAAAAAAAAAAAAA+
+aaAAA++++++++++AA+++++++++++++A+
++a0AAAAAAAAAAAAAa+AAAAAAAAAAAAA+
++a+++++++++++++a++A+++++++++++++
++aaaaaaaaaaaaaaa+AAAAAAAAAAAAAA+
++aaaaaaaaaaaaaaa++++++++++++++A+
++aaaaaaaaaaaaaaa+AAAAAAAAAAAAAA+
++aaaaaaaaaaaaaaa+A++++++++++++++
++aaaaaaaaaaaaaaa+AAAAAAAAAAAAAA+
++a+a+a+a+a+a+a+a++++++++++++++A+
++a+a+a+a+a+a+a+a+AAAAAAAAAAAAAA+
++a+a+a+a+a+a+a+a+A++++++++++++++
++a+a+a+a+a+a+a+a+AAAAAAAAAAAAAA+
++a+a+a+a+a+a+a+a+++++A++++A+++A+
++a+a+a+a+a+a+a+a+++L+A+MM+A+++++
+++++++++++++++++++++++++++++++++
