+++++++++++++++++++
+0  +  milk BaNaNa+
+                 +
+   CORDLESS      +
+d  DRILL   c  ++++
+ r          o   ++
+  i NETTO    +  l+
+   l          r e+
+    lMILK      ds+
+      MILK      s+
+ MILK MILK MILK  +
+    MILK MILK    +
+   bAnAnA   MILK +
+m      MILK      +
+i  MILK          +
+l        MILK    +
+k       NETTO    +
+++++++++++++++++++
