+++++++++++++++++++
+      0+B        +
+       +a        +
+       +         +
+       +         +
+       +         +
+       +         +
+       +         +
+       +         +
+       +         +
+       +         +
+  A    +         +
+  b    +         +
+       +         +
+       +         +
+       +         +
+       +         +
+       +         +
+       +         +
+       +         +
+       +         +
+       +         +
+                 +
+++++++++++++++++++
