+++++++++++
++   A  b++
++c     d++
+++++ +++++
+++++e+++++
+++++f+++++
+++++g+++++
+++++h+++++
+++++i+++++
+++++j+++++
+++++ +++++
+ 0       +
+       B +
+ C     D +
+ E     F +
+         +
+G     H  +
+  I   J  +
+         +
+    a    +
+++++++++++
