+++++++++++++++++
+0 C            +
+    D  +++++++++
+  A    e dc a b+
+     E +++++++++
+        B      +
+++++++++++++++++
