+++++++++++++++++++
+  0              +
+S+ +a+ +a+ +b+ +B+
+Q+ +c+ +a+ +d+ +D+
+O+ +e+ +a+ +f+ +F+
+M+ +g+ +a+ +h+ +H+
+K+ +i+ +a+ +j+ +J+
+I+ +k+A+a+A+l+ +L+
+G+ +m+A+a+A+n+ +N+
+E+ +o+A+a+A+p+ +P+
+C+ +q+A+a+A+r+ +R+
+A+ +s+A+a+A+t+ +T+
+++++++++++++++++++
