+++++++++++++++++++++++++++++++++++++++++++++++++
+a  b c d e f g h i j k    +Y                   +
+b++c+d+d+++++++++++++++++++++ ++++++++++++++++ +
+c++d+e+d+++++++++++++++++++   +                +
+dhie+f+ddddd             ++ ++  ++++++++++++++++
+++++++++++++++++++++++++ +  ++                 +
+        X        0         +++++++++++++++++++ +
+++DDDDD+++++++ ++++++++++++                    +
  +ACEGIL+    +X+            ++++++++++++++++++++
+++      ++++++D+ +++++++++++++++++++++++++++++++
+BDFHJKAAFFEE++++                               +
+XDDDDBBCCHII++++++++++++++++++++++++++++++++++ +
++++++++++++++                                  +
+              ++++++++++++++++++++++++++++++++++
+ +++++++++++++++++++++++++++++++++++++++++++++++
+                                              Z+
+++++++++++++++++++++++++++++++++++++++++++++++y+
+++++++++++++++++++++++++++++++++++++++++++++++++
