+++++++++++++++++
+a C bB cd      +
+++++++++++++  0+
+efghEGHF   p  M+
+++++++++++++  N+
+L  Srs     m  O+
+++++++++++++  P+
+q  J  K  Q n  R+
+++++++++++++  D+
+ij  I   kl o  A+
+++++++++++++++++
