+++++++++
+a+   A0+
+c+   A +
+b+   A +
+a+ + C +
+ba + B +
+   + B +
+++++++++
