+++++++++++++++++++++++++++++++++++++++++++
+                              Cc+       b+
+  B                    ++++++++ + ++++++++
+ +++++++++++++++++++++ ++++++++   ++++++++
+ +     K A L D I     +0+++++++++++++++++++
+ +++++++++++++++++++++++++++++++++++++++++
+ E       e                               +
+ E            e                          +
+ E            e                          +
+ E            e                          +
+ E                     e                 +
+ E                     e                 +
+ E                        e              +
+ E                        e              +
+ E                                   e   +
+ E                                    e  +
+ E                                     e +
+ E                                      e+
+ E                                      e+
+ E                                      e+
+ E                                      e+
+ E                                      e+
+ E                                      e+
+ E                                      e+
+ E                                      e+
+ E                                      e+
+ E                                      e+
+ E                                      e+
+ E                                      e+
+ E                                      e+
+ E                                      e+
+ E                                      e+
+ E                                      e+
+ E                                      e+
+ E                                      e+
+ E                                      e+
+ E                                      e+
+++++++++   +++++++++++++++++++++++++++++++
++ i h ++                      q         w+
++j++++++                     +++++++++++++
++klns+++                    Q+++++++++++++
+++++r+++                     +++++++++++++
++   p+++                                W+
++ ++++++                     +++++++++++++
++     o                      +++++++++++++
+++++++++ H I J K L N S R P O +++++++++++++
+++++++++++++++++++++++++++++++++++++++++++
