                ++++++++
                + b  b +
+++++++++++++++++ B    +
+ aA   0             B +
+ aA                   +
+++++++++++++++++c     +
                +   C C+
                +c     +
                ++++++++
