+++++++++++++
+c+++F+++f+++
+b+++e+++G+++
+a+++d+++ +++
+ A   DE    +
+           +
+B    0    C+
+++++++++++++
