++++++++++++++++++++++++++
+CREATING+ITALIC+LIFELINE+
+ + + + ++++  ++++ + + + +
+                        +
+           0            +
+++++++ artificial +++++++
+++++++            +++++++
+++++++intelligence+++++++
++++++++++++++++++++++++++
