+++++++++++++++++++++++++++++
+a++++++++++++a++++++++++++a+
+aacceeggiikkmmooqqssuuwwyya+
++++++++++++++M++++++++++++++
+AAAA+++++++++K++++++++YYWWU+
+AA+++++++++++K+++++++++++US+
+AA+++++++++++I+++++++++++SQ+
+CC+++++++++++I+++++++++++QO+
+EE+++++++++++G+++++++++++OM+
+ ++++++++++++G++++++++++++ +
+            a a            +
++++++++++++++ ++++++++++++++
++++++++++++++ ++++++++++++++
++++++++++++++0++++++++++++++
++++++++++++++ ++++++++++++++
++++++++++++++ ++++++++++++++
+            b b            +
+ ++++++++++++F++++++++++++ +
+LN+++++++++++F+++++++++++DD+
+NP+++++++++++H+++++++++++BB+
+PR+++++++++++H+++++++++++BB+
+RT+++++++++++J+++++++++++BB+
+TVVZZ++++++++J+++++++++BBBB+
++++++++++++++L++++++++++++++
+bbddffhhjjllnnpprrttvvzzbbb+
+b++++++++++++b++++++++++++b+
+++++++++++++++++++++++++++++
