+++++++++++++++++++++++++++
+            +        i   +
+ ++++ +++++ + +++++ ++++ +
+ +  + +   + + +   + +  + +
+ ++++ +++++ + +++++ ++++ +
+  i                      +
+ ++++ ++ +++++++ ++ ++++ +
+ ++++ ++ +++++++ ++ ++++ +
+      ++    +    ++      +
++++++ +++++ + +++++ ++++++
     + +++++ + +++++ +
     + ++         ++r+
     + ++ +++ +++ ++ +
++++++ ++ +     + ++ ++++++
+   k     +     +         +
++++++ ++ +  0  + ++ ++++++
   + + ++ ++++ ++ ++
   + +  + NIKRIMA  + +
   + + ++         ++ +
++++++ ++ +++++++ ++ ++++++
+            +           m+
+ ++++ +++++ + +++++ ++++ +
+ ++++ +++++ + +++++ ++++ +
+a  ++               ++   +
+++ ++ ++ +++++++ ++ ++ +++
+++ ++ ++ +++++++ ++ ++ +++
+      ++    +    ++      +
+ ++++++++++ + ++++++++++ +
+ ++++++++++ + ++++++++++ +
+    n                    +
+++++++++++++++++++++++++++
