+++++++++++++++++++++++++++++++++++++++
+                                     +
+ +++++++++++++++++++++++++++++++++++ +
+ +                                 g +
+ +a+++++++++++++++++++++++++++++++++ +
+ +                                 + +
+ +  + +++++    + +++++    +++++++  + +
+ + +  ++++ +  +  +++  +  +   ++  + + +
+ + + +    ++  + +   + +  + +   + + + +
+ + + +++++++  + +   + +  + +++++ + + +
+ + +     +++  + +   + +  +  +++  + + +
+ + + ++ +     + +   +      +   + + + +
+ + + + + +++  + +++++ +  + +   + + + +
+ + ++   ++++  +++++++++  ++     ++ + +
+ +                               + + +
+ ++++++++++++++G++++++++++++++++++++ +
+A+0                                  +
+++++++++++++++++++++++++++++++++++++++
