+++++++++++++++++++++
+a+                 +
+b+G B C D E HIJ    +
+c+                 +
+d+                 +
+e+                 +
+g+                 +
+h+                 +
+i+                 +
+j+                 +
+ +                 +
+ +                 +
+ +                 +
+ +                 +
+                   +
+                   +
+                   +
+       +++++++++++++
+     A0+
+++++++++
