red: 0,1,B
++++++++
+0 B b +
+      +
+  1   +
++++++++
