red: 0,A
green: 1
++++++++++++++
+++  0     +a+
+++ ++++++++A+
+ +1         +
++++++++++++ +
+          + +
++++++++++++++
