red: 0,1,A
blue: 2,B
+++++++++++++++
+ a   a   b   +
+ A   A   B   +
+ 0   1   2   +
+             +
+++++++++++++++
