red: 0,A
blue: 1,B
cyan: 2,C
yellow: 3,D
pink: 4,E
++++++++++++++++
+++++DB+B+++2+++
++++++A+C+++B+++
++c++          +
+cdebA CCC    0+
++cE+          +
+++4++C+++++A+++
++++++3+++++1+++
++++++++++++++++
