++++++++++++++
+       KALLE+
+pp        ++++++++
+p p       +   E  +
+p I       ++++++ +
+0 SISP    kalle+ +
+     P    ++++++ +
+   P P    E      +
+     P           +
+                 +
+++++++++++++++++++
