++++++++++++++++++++++++++
+0                   +
+ +                  +
+ +       AAAAAA     +
+ +       AAAAAA     +
+ +       AAAAAA     +
+ +       AAAAAA     +
+ +       AAAAAA     +
+ +       AAAAAA     +
+ +       AAAAAA     +
+ +       AAAAAA     +
+ +       AAAAAA     +
+ +       AAAAAA     +
+ +       AAAAAA     +
+ +       AAAAAA     +
+ +       AAAAAA     +
+ +       AAAAAA     +
+ +       AAAAAA     +
+ +++++   AAAAA      +
+a+   +              +
+A+   +              +
++++++++++++++++++++++++++
