+++++++++++++++++++++++++++++++++++++++++++++++++++++++++++++++++++++
+                                                                   +
+                                                                   +
+                                                                   +
+                                                                   +
+                                   +                               +
+                                  +a+                              +
+                                  +A+                              +
+ ++++++++++++++++++++++++++++++++++ +++++++++++++++++++++++++++++  +
+                                                                   +
+ ++++++++++++++++++++++++++++++++++ +++++++++++++++++++++++++++++  +
+                                                                   +
+ ++++++++++++++++++++++++++++++++++ +++++++++++++++++++++++++++++  +
+                                   0                               +
+                                                                   +
+                                                                   +
+                                                                   +
+                                                                   +
+                                                                   +
+                                                                   +
+                                                                   +
+                                                                   +
+                                                                   +
+                                                                   +
+                                                                   +
+                                                                   +
+                                                                   +
+                                                                   +
+                                                                   +
+                                                                   +
+++++++++++++++++++++++++++++++++++++++++++++++++++++++++++++++++++++
