++++++++
+0+  cb+
+ A+ ad+
+ +B+  +
+  DC+ +
+ ++++ +
+      +
++++++++