++++++++++++++++++++++
+0                   +
++  ++++++++ +++++++ +
++  +      + +     +B+
++  +      + +     + +
++  +      +b+     + +
++  +      + +     + +
++ c+ A    + +     + +
++  ++++++++ +++++++ +
+A       C          a+
++++++++++++++++++++++
