+++    +++
       +++    +++
       +B+    +f+
++++++++A++++++e+++++++++
++++                 ++++
++ba                 GH++
++++                 ++++
++++      0          ++++
++++                 ++++
++cd                 EF++
++++                 ++++
++++++++g++++++D+++++++++
++++++++h++++++C+++++++++
+++++++++++++++++++++++++
+++++++++++++++++++++++++
