+++++++++++++++++++++++++++++++++++++++
++++m+Q               A        P      +
+++  +    K C   F   P    A          N +
++   +M        F    B         O       +
+    WW  L   J         C  AA  S       +
+    WW    T         E          B     +
++   +R  H   I  T      D              +
+++  +         X  A    U       R   X  +
++++n+  Q           G        0      T +
+++++++++++++++++++++++++++++++++++++++
