+++++++++++++++++++++++++++++++++++++++
++++m+Q               A        P      +
+++gn+    K C   F   P    A          N +
++cho+M        F    B         O       +
+adipWW  L   J         C  AA  S       +
+bejqWW    T         E          B     +
++fkr+R  H   I  T      D              +
+++ls+         X  A    U       R   X  +
++++t+  Q           G        0      T +
+++++++++++++++++++++++++++++++++++++++
