++++++++++++++++++++++++
+0A                   a+
+                      +
+                      +
+                      +
+                      +
+                      +
+                      +
+                      +
+                      +
+                      +
+                      +
+                      +
+                      +
+                      +
+                      +
+                      +
+                      +
+                      +
+                      +
+                      +
+                      +
+                      +
++++++++++++++++++++++++
