++++++++++++
+0A       a+
+          +
+          +
+          +
+          +
+          +
+          +
+          +
+          +
+          +
++++++++++++
