++++++++++++++++++++++++++++++++++++++++++++++++
+0A                                           a+
+                                              +
+                                              +
+                                              +
+                                              +
+                                              +
+                                              +
+                                              +
+                                              +
+                                              +
+                                              +
+                                              +
+                                              +
+                                              +
+                                              +
+                                              +
+                                              +
+                                              +
+                                              +
+                                              +
+                                              +
+                                              +
+                                              +
+                                              +
+                                              +
+                                              +
+                                              +
+                                              +
+                                              +
+                                              +
+                                              +
+                                              +
+                                              +
+                                              +
+                                              +
+                                              +
+                                              +
+                                              +
+                                              +
+                                              +
+                                              +
+                                              +
+                                              +
+                                              +
+                                              +
+                                              +
++++++++++++++++++++++++++++++++++++++++++++++++
